#######################
#      #########      #
#      #       #      #
#      #   #   #      #
#      #  ###  #      #
#      #  ###  #      #
#      #  ###  #      #
#      #   #   #      #
#                     #
#######################