###############################
#                             #
#      ####################   #
#      #                  #   #
#      #    ###########   #   #
#      #    #         #   #   #
#      #    #         #   #   #
#      #    #   #######   #   #
#      #    #             #   #
#      #    ###############   #
#                             #
###############################